{
	"levelRows" : [
		"...................E",
		"AAAAAAA............E",
		"...P..A....C....C..E",
		"......A....CC...CC.E",
		"....AAA....CCC...CCE",
		"......B.....CC....CE",
		"......B......CC...CE",
		"..............C...CE",
		"BBB...........C...CE",
		"..CC..CC......C...CE",
		".......CCCCCCCC...CE",
		"....CCCC..........CE",
		"..CCCC.........Q..CE",
		"..................CE",
		"..................CE"
	]
}