{
	"levelRows" : [
		".D..DD..D...........",
		"DD..DD..DFFDDDDFFFFF",
		"..............B..Q..",
		"..........P...B.....",
		"...AA.........B.....",
		"...AA.........BBBB..",
		"A..AA..AA..AAAB.....",
		"A......AA..A..B.....",
		"A......AA..A..B..BBB",
		"...C..........B.....",
		"...C..........B.....",
		"C..CCCCCCEECCCCCCC..",
		"C...E.E.E.E.E.E.E...",
		"C...................",
		"C..................."
	]
}