{
	"levelRows" : [
		".................AAA",
		"AAAAAAAA.........ABA",
		".A.P.......EEE...ABA",
		"..AAAAAAAAEEE....AAA",
		"...A................",
		"....A...............",
		".....A..............",
		"......A....A........",
		"......C....C........",
		"......C....C........",
		"......C....C........",
		"......D....D........",
		".......D....D.......",
		"........D..Q.D......",
		".........DDDDDD....."
	]
}