{
	"levelRows" : [
		"...................P",
		"AAA...AAAAAAAAAAAAAA",
		"....................",
		"...............BB...",
		"...A....A...A..AA..A",
		"...AA..AA....A.AA.A.",
		"...AAAAAA.....ACCA..",
		"....ABBA............",
		".....CC.......A.A.A.",
		"...........ABBBBBBBB",
		"...........AB.....BB",
		".....DD........Q..BB",
		"....EEEE..........BB",
		"...FF..FF..AB.....BB",
		"...FF..FF..ABBBBBBBB"
	]
}