{
	"levelRows" : [
		"ADC..A..BAB.........",
		"APC..A...E..........",
		"A.C..A.......AAAA...",
		"B.B..A.......A......",
		"B.B..A...E...A......",
		"B.B..A..BAB..A..BBBB",
		"C.A..A..BAB..A......",
		"C.A..A..BAB..A......",
		"C.A..A..BAB..A..CCCC",
		".....A...E...A......",
		".....A.......A......",
		"F.F..A.......A......",
		"F.F..A...E...A......",
		"F.F.....BAB..A..E.QE",
		"FDF.....BAB..A..EEEE"
	]
}